###############################
#p    * **    *   r   r       #
# # # #*# # # # # # # # # # # #
#      ** N *  *   * ** r *   #
# # # # # #*# # # # # # #*# # #
#*   * K    *b* *   **        #
# # # # # # # # # # # # # #*# #
#    *     *        *    **  r#
# #*# # #*#*#*#*# # #1# # #*# #
#        * r *r*    *   R     #
#*# # # # # # # # # # #*# # #*#
#**    * **    ** **D     s   #
###############################