###############################
#p * *r       *  ** * *      *#
# # # # #*# # #*# # # # # #*# #
#    * * *** **      *    **  #
# #*# # # # #s# #b#s# # # # #*#
#          K     **      *  R*#
# # #*# # # # # #*#*#*#*# # # #
#   *        *   * *D* *  N   #
# # # # #*# # # # # # #*# #*# #
#   ****         *s           #
# # # # # # # # # #*# # # # #*#
#  ** *   *    r              #
###############################