###############################
#p    *r*     *   r   r       #
# # # #*# # # # # # # # # # # #
#       * N *  *   * ** r *   #
# # # # # #*#*# # # # # #*# # #
#*   * K    *b* *   **        #
# # # # # # #*# # # # # # #*# #
#    *     *        *    **  r#
# #*# # #*#*#*# # # #1# # #*# #
#        *   **r    *   R     #
#*# # # # # # # # # # #*# # #*#
#**    * **    ** **D  r  s   #
###############################